{
  "status": "success",
  "data": {
    "desempenho": {
      "levelDistribution": [
        {
          "level": "NP",
          "minPoints": 0,
          "maxPoints": 0,
          "count": 163,
          "municipios": [
            "2300804",
            "2300507",
            "2301109",
            "2301257",
            "2301703",
            "2301802",
            "2301901",
            "2302057",
            "2302404",
            "2300903",
            "2301950",
            "2302602",
            "2302008",
            "2302909",
            "2303105",
            "2303204",
            "2303303",
            "2303402",
            "2303600",
            "2303659",
            "2303709",
            "2303808",
            "2303907",
            "2303931",
            "2303956",
            "2302701",
            "2304103",
            "2302800",
            "2304202",
            "2304236",
            "2304251",
            "2304269",
            "2304277",
            "2304285",
            "2304301",
            "2304004",
            "2304459",
            "2304509",
            "2302503",
            "2304608",
            "2304657",
            "2304707",
            "2304806",
            "2304905",
            "2304954",
            "2305001",
            "2305100",
            "2305209",
            "2305233",
            "2305266",
            "2305308",
            "2305332",
            "2305357",
            "2305506",
            "2305654",
            "2305704",
            "2305803",
            "2305902",
            "2306009",
            "2305605",
            "2306207",
            "2306256",
            "2306306",
            "2306405",
            "2304350",
            "2306603",
            "2306108",
            "2306702",
            "2306801",
            "2306504",
            "2307007",
            "2307106",
            "2307205",
            "2306553",
            "2307403",
            "2307254",
            "2307601",
            "2307635",
            "2306900",
            "2307700",
            "2307809",
            "2307304",
            "2308005",
            "2307502",
            "2308104",
            "2308203",
            "2308302",
            "2308351",
            "2308377",
            "2308401",
            "2307908",
            "2308708",
            "2307650",
            "2308906",
            "2309003",
            "2309102",
            "2309201",
            "2309300",
            "2308500",
            "2309458",
            "2309508",
            "2308609",
            "2309706",
            "2309805",
            "2309904",
            "2310001",
            "2310100",
            "2310209",
            "2310258",
            "2310308",
            "2310407",
            "2310506",
            "2310605",
            "2310704",
            "2310803",
            "2308807",
            "2310902",
            "2309409",
            "2311009",
            "2309607",
            "2311108",
            "2311207",
            "2311231",
            "2311264",
            "2311306",
            "2311355",
            "2311405",
            "2311504",
            "2311603",
            "2311702",
            "2310852",
            "2311959",
            "2311801",
            "2312007",
            "2312106",
            "2310951",
            "2312403",
            "2311900",
            "2312502",
            "2312601",
            "2312700",
            "2312809",
            "2312908",
            "2313005",
            "2313104",
            "2313203",
            "2312205",
            "2313351",
            "2313401",
            "2312304",
            "2313500",
            "2313559",
            "2313252",
            "2313708",
            "2313757",
            "2313807",
            "2313906",
            "2313302",
            "2314003",
            "2314102",
            "2313955",
            "2303006",
            "2313609"
          ]
        },
        {
          "level": 0,
          "minPoints": 0,
          "maxPoints": 0,
          "count": 11,
          "municipios": [
            "2300606",
            "2301208",
            "2301307",
            "2302107",
            "2302305",
            "2300150",
            "2303501",
            "2305407",
            "2304400",
            "2300309",
            "2300101"
          ]
        },
        {
          "level": 1,
          "minPoints": 1,
          "maxPoints": 100,
          "count": 10,
          "municipios": [
            "2300408",
            "2300754",
            "2301000",
            "2300705",
            "2301406",
            "2301505",
            "2301604",
            "2301851",
            "2302206",
            "2300200"
          ]
        },
        {
          "level": 2,
          "minPoints": 101,
          "maxPoints": 200,
          "count": 0,
          "municipios": []
        },
        {
          "level": 3,
          "minPoints": 201,
          "maxPoints": 300,
          "count": 0,
          "municipios": []
        }
      ],
      "totalMunicipios": 184
    },
    "totalParticipatingPrefeituras": 21,
    "percentageFinishedMissions": 1.7512077294685993
  }
}